"a" = (/turf/simulated/mineral/random,/area/space)
"c" = (/obj/effect/wallframe_spawn/reinforced_phoron,/turf/simulated/wall/r_wall,/area/space)
"e" = (/obj/machinery/r_n_d/protolathe,/turf/simulated/floor/tiled,/area/space)
"i" = (/obj/effect/wallframe_spawn/reinforced_phoron,/turf/simulated/floor/reinforced,/area/space)
"p" = (/turf/simulated/wall/r_wall,/area/space)
"q" = (/turf/template_noop,/area/space)
"r" = (/obj/effect/wallframe_spawn/reinforced_phoron,/turf/simulated/floor/tiled,/area/space)
"s" = (/turf/simulated/floor/reinforced/hydrogen,/area/space)
"t" = (/obj/machinery/smartfridge,/turf/simulated/floor/tiled,/area/space)
"u" = (/obj/machinery/chemical_dispenser,/turf/simulated/floor/tiled,/area/space)
"v" = (/obj/machinery/door/airlock/external{frequency = 1380; id_tag = "playablecolonymain_exterior_door"; locked = 1},/turf/simulated/floor/tiled,/area/space)
"w" = (/obj/structure/table/steel,/turf/simulated/floor/tiled,/area/space)
"x" = (/obj/effect/wallframe_spawn/reinforced,/turf/simulated/floor/tiled,/area/space)
"y" = (/turf/simulated/floor/grass,/area/space)
"z" = (/obj/structure/table/steel,/obj/machinery/smartfridge/chemistry,/turf/simulated/floor/tiled,/area/space)
"C" = (/obj/machinery/r_n_d/circuit_imprinter,/turf/simulated/floor/tiled,/area/space)
"E" = (/turf/simulated/floor/reinforced,/area/space)
"F" = (/obj/machinery/r_n_d/destructive_analyzer,/turf/simulated/floor/tiled,/area/space)
"I" = (/turf/simulated/floor/reinforced/nitrogen,/area/space)
"L" = (/turf/simulated/floor/reinforced/oxygen,/area/space)
"N" = (/obj/effect/wallframe_spawn/reinforced_phoron,/turf/space,/area/space)
"O" = (/turf/simulated/floor/reinforced/carbon_dioxide,/area/space)
"T" = (/obj/machinery/fabricator,/turf/simulated/floor/tiled,/area/space)
"V" = (/obj/machinery/portable_atmospherics/hydroponics,/turf/simulated/floor/tiled,/area/space)
"W" = (/obj/machinery/computer/rdconsole,/turf/simulated/floor/tiled,/area/space)
"Y" = (/turf/simulated/floor/tiled,/area/space)
"Z" = (/obj/machinery/chem_master,/turf/simulated/floor/tiled,/area/space)

(1,1,1) = {"
aaaaaaaaaaaaaaaaaaaaaaaaaaaaaaaaaaaaaaaaaaaaaaaaaaaaaaaaaaaaaaaaaaaaaa
aaaaaaaaaaaaaaaaaaaaaaaaaaaaaaaaaaaaaaaaaaaaaaaaaaaaaaaaaaaaaaaaaaaaaa
aaaaaaaaaaaaaaaaaaaaaaaaaaaaaaaaaaaaaaaaaaaaaaaaaaaaaaaaaaaaaaaaaaaaaa
aaaaaaaaaaaaaaaaaaaaaaaaaaaaaaaaaaaaaaaaaaaaaaaaaaaaaaaaaaaaaaaaaaaaaa
aaaaaaaaaaaaaaaaaaaaaaaaaaaaaaaaaaaaaaaaaaaaaaaaaaaaaaaaaaaaaaaaaaaaaa
aaaaaaaaaaaappppppaaaaaappppppaaaaaaaaaaaaaaaaaaaaaaaaaaaaaaaaaaaaaaaa
aaaaaaaaaaappYYYYppaaaappYYYYppaaaaaaaaaaaaaaaaaaaaaaaaaaaaaaaaaaaaaaa
aaaaaaaaaappYYYYYYppaappYYYYYYppaaaaaaaaaaaaaaaaaaaaaaaaaaaaaaaaaaaaaa
aaaaaaaaaapYYYYYYYYppppYYYYYYYYpaaaaaaaaaaaaaaaaaaaaaaaaaaaaaaaaaaaaaa
aaaaaaaaaapYYYYYYYYYYYYYYYYYYYYpaaaaaaaaaaaaaaaaaaapppppppppppaaaaaaaa
aaaaaaaaaapYYYYYYYYYYYYYYYYYYYYpaaaaaaaaaaaaaaaaaappYYYYYYYYYppaaaaaaa
aaaaaaaaaapYYYYYYYYppppYYYYYYYYpaaaaaaaaaaaaaaaaappYYYYYYYYYYYppaaaaaa
aaaaaaaaaappYYYYYYppaappYYYYYYppaaaaaaaaaaaaaaaaapYYYYYYYYYYYYYpaaaaaa
aaaaaaaaaaappYYYYppaaaappYYYYppaaaaaaaaaaaaaaaaaapYYYpppppppYYYpaaaaaa
aaaaaaaaaaaappYYppaaaaaappYYpppppppppppppppaaaaaapYYYpEEEEEpYYYpaaaaaa
aaaaaaaaaaaaapYYpaaaaaaappYYpppYYxYYYYYYYYpaaaaaapYYYiEEEEEiYYYpaaaaaa
aaaappppppppppYYppaaaaappYYYYppYYxYYYYYYYYpaaaaaapYYYiEEEEEiYYYpaaaaaa
aaappYYYYYYYpYYYYpppppppYYYYYYpYYxYYYYYYYYpaaaaaapYYYiEEEEEiYYYpaaaaaa
aappYYYYYYYYYYYYYYYYYYYYYYYYYYYYYxYYYYYYYYpaaaaaapYYYpEEEEEpYYYpaaaaaa
aapYYYYYYYYYYYYYYYYYYYYYYYYYYYYYYYYYYYYYYYpaaaaaapYYYpEpppEpYYYpaaaaaa
aapYYYYYYYYYpYYYYpppppppYYYYYYppppYzppppYppaaaaaapYYYYYYYYYYYYYpaaaaaa
aapYYpppppppppYYppyyyyyppYYYYppwYYYYYwpYYYpaaaaaappYYYYYYYYYYYppaaaaaa
aapYYpYYYpYYYpYYpyyyyyyyppYYpppwYYYYYwpYYYpaaaaaaappYYYYYYYYYppaaaaaaa
aapYYYYYYpYYYYYYpyyyyyyyppYYpppFWwYYwwpYYYpaaaaaaaapppYpppNNNpaaaaaaaa
aapYYpYYYpYYYpYYpyyyyyyypYYYYppYYYYYYupYYYpaaaaaaaaapYYYppYYYpaaaaaaaa
aapYYpYYYpYYYpYYpyyyyyyypYYYYYpCeTYYYZpYYYpaaaaaaaaappYpppYYYpaaaaaaaa
aapYYpppppppppYYpyyyyyyypYYYYYppppwYpppYYYpaaaaaaaaapYYYYYYYYpaaaaaaaa
aapYYYYYYYYYYYYYYyyyyyyyYYYYYYYYYYYYYYYYYYpaaaaaaaaapYYYYpYYYpaaaaaaaa
aapYYYYYYYYYYYYYYyyyyyyyYYYYYYYYYYYYYYYYYYpaaaaaaaaapppYppppppaaaaaaaa
aapYYpppppppppYYpyyyyyyypYYYYYppppYtpppYYYpaaaaaaaaapYYYYYpaaaaaaaaaaa
aapYYpYYYpYYYpYYpyyyyyyypYYYYYpVVVYYYYpYYYpaaaaaaaaapYYYYYpaaaaaaaaaaa
aapYYpYYYpYYYpYYpyyyyyyypYYYYppYYYYYYYpYYYpaaaaaaaaapYYYYYpaaaaaaaaaaa
aapYYYYYYpYYYYYYpyyyyyyyppYYpppVVVYYYYpYYYpaaaaaaaaappYYpppaaaaaaaaaaa
aapYYpYYYpYYYpYYpyyyyyyyppYYpppYYYYYYYpYYYpaaaaaaaaaapYYpaaaaaaaaaaaaa
aapYYpppppppppYYppyyyyyppYYYYppVVVYYYYpYYYpaaaaaaaaaapYYpaaaaaaaaaaaaa
aapYYYYYYYYYpYYYYpppppppYYYYYYppppppppppYppaaaaaaaaaapYYpaaaaaaaaaaaaa
aapYYYYYYYYYYYYYYYYYYYYYYYYYYYpYYYYYYYYYYYpaaaaaaaaaapYYpaaaaaaaaaaaaa
aappYYYYYYYYYYYYYYYYYYYYYYYYYYpYYYYYYYYYYYpaaaaaaaaaapYYpaaaaaaaaaaaaa
aaappYYYYYYYpYYYYpppppppYYYYYYpYYYYYYYYYYYpaaaaaaaaaapYYpaaaaaaaaaaaaa
aaaappppppppppYYppaaaaappYYYYppYYYYYYYYYYYpaaaaaaaaaapYYpaaaaaaaaaaaaa
aaaaaaaaaaaaapYYpaaaaaaappYYpppYYYYYYYYYYYpaaaaaaaaaapYYpaaaaaaaaaaaaa
aaaaaaaaaaaaapYYpaaaaaaaapYYpapYYYYYYYYYYYpaaaaaaaaaapYYpaaaaaaaaaaaaa
aaaaaaaaaaaaapYYpaaaaaaaapYYpapYYYYYYYYYYYpaaaaaaaaaapYYpaaaaaaaaaaaaa
aaaaaaaaaaaaapYYppppppppppYYppppYYppppppppppppppppppppYYpaaaaaaaaaaaaa
aaaaaaaaaaaaapYYYYYYpYYYYYYYYYYYYYYYYYYYYYYYYYYYYYYYYYYYpaaaaaaaaaaaaa
aaaaaaaaaaaaapYYYYYYpYYYYYYYYYYYYYYYYYYYYYYYYYYYYYYYYYYYpaaaaaaaaaaaaa
aaaaaaaaaaaaapppppYYpYYpppYYpppppYYppppppppppppppppppppppaaaaaaaaaaaaa
aaaaaaaaaaaaaaaaapYYYYYpYYYYYYppYYYYYYYYYYYpaaaaaaaaaaaaaaaaaaaaaaaaaa
aaaaaaaaaaaaaaaaapYYYYYpYYYYYYppYYYYYYYYYYYpaaaaaaaaaaaaaaaaaaaaaaaaaa
aaaaaaaqaqaaaaaaapYYYYYpYYYYYYppYYYYYYYYYYYpppppaaaaaaaaaaaaaaaaaaaaaa
aaaaaaqqqqqqapppppccYccpYYYYYYppYYYYYYYYYYYrssspaaaaaaaaaaaaaaaaaaaaaa
aaaaaqqqqqqqqpYYYpYYYYYpYYYYYYppYYYYYYYYYYYrssspaaaaaaaaaaaaaaaaaaaaaa
aaaaqqqqqqqqqvYYYvYYYYYppppppppprrrrprrrprrpppppaaaaaaaaaaaaaaaaaaaaaa
aqaqqqqaqaqqqpYYYpYYYYYpaaaaaaapIIIIpLLLpOOpaaaaaaaaaaaaaaaaaaaaaaaaaa
qqqqqqaaaaaqapppppppppppaaaaaaapIIIIpLLLpOOpaaaaaaaaaaaaaaaaaaaaaaaaaa
qqqqaaaaaaaaaaaaaaaaaaaaaaaaaaapIIIIpLLLpOOpaaaaaaaaaaaaaaaaaaaaaaaaaa
aaqqaaaaaaaaaaaaaaaaaaaaaaaaaaapppppppppppppaaaaaaaaaaaaaaaaaaaaaaaaaa
aaaaaaaaaaaaaaaaaaaaaaaaaaaaaaaaaaaaaaaaaaaaaaaaaaaaaaaaaaaaaaaaaaaaaa
aaaaaaaaaaaaaaaaaaaaaaaaaaaaaaaaaaaaaaaaaaaaaaaaaaaaaaaaaaaaaaaaaaaaaa
aaaaaaaaaaaaaaaaaaaaaaaaaaaaaaaaaaaaaaaaaaaaaaaaaaaaaaaaaaaaaaaaaaaaaa
"}
